# ## #
#  # #
# # ##
## ###
######$#


