########@
#       
# ###### 
# #    #
# ###$ #
#      #
########

