@#### ###
#### ####
###### ##
     # ##
###### ##
##### $##

