            
 @######### 
 #     #    
 ##### #### 
  #  ##   #
  #   # ### 
 ### ## # # 
 #      # # 
    ##### # 
   $#     # 
     ###### 
            
