~~~~~~~~~~~~
~@#########~
~#~~~~~#~~~~
~#####~####~
~~#~~##~~~#
~~#~~~#~###~
~###~##~#~#~
~#~~~~~~#~#~
~~~~#####~#~
~~~$#~~~~~#~
~~~~~######~
~~~~~~~~~~~~
