 @      
 #      
 ###### 
      # 
 ##   # 
 #  ### 
### #   
# ##### 
#       
######  
     $  
